0 0 0 0 0 0 0 0 0 0 0 0 0 0 0 0 0 0 0 0 0 0 0 0 0 0 0 0 0 0 0 0 0 0 0 0 0 0 0 0 0 0 0 0 0 0 0 0 0 0 
0 0 0 0 0 0 0 0 0 0 0 0 0 0 0 0 0 0 0 0 0 0 0 0 0 0 0 0 0 0 0 0 0 0 0 0 0 0 0 0 0 0 0 0 0 0 0 0 0 0 
0 0 0 0 0 0 0 0 0 0 0 0 0 0 0 0 0 0 0 0 0 0 0 0 0 0 0 0 0 0 0 0 0 0 0 0 0 0 0 0 0 0 0 0 0 0 0 0 0 0 
0 0 0 8 8 0 0 0 0 0 0 0 0 0 0 0 0 8 8 8 0 0 0 0 0 0 0 0 0 0 0 0 0 0 0 0 0 0 0 0 0 0 0 0 0 0 0 0 0 0 
0 0 0 8 8 8 8 0 0 0 0 0 0 0 0 0 8 8 8 8 8 8 0 0 0 0 0 0 0 0 0 0 0 0 0 0 0 0 0 0 0 0 8 8 8 8 8 0 0 0 
0 0 0 8 3 8 8 8 8 8 0 0 0 8 8 8 8 8 8 8 8 8 8 8 0 0 0 0 0 0 0 0 8 8 8 8 8 8 8 8 8 8 8 8 10 8 8 0 0 0 
0 0 0 0 1 1 1 1 1 1 1 8 8 8 8 8 8 8 8 8 8 8 8 8 8 8 0 0 0 0 0 8 8 8 8 8 8 8 8 8 8 8 8 8 8 8 8 0 0 0 
0 0 0 0 8 8 8 8 8 8 1 8 8 8 8 8 8 8 8 8 8 8 10 8 8 8 8 8 8 8 0 8 8 8 8 8 8 8 8 8 8 8 8 5 8 8 8 0 0 0 
0 0 0 0 0 8 8 8 8 8 1 8 8 8 8 8 8 8 8 8 8 8 9 8 8 8 8 8 8 8 2 8 8 8 8 8 8 8 8 8 4 5 5 9 4 4 4 0 0 0 
0 0 0 0 0 8 8 8 8 8 1 8 8 8 8 8 8 8 8 8 8 8 0 8 8 8 8 8 8 8 0 8 8 4 4 4 4 4 4 4 5 5 5 9 4 4 4 0 0 0 
0 0 0 0 0 8 8 8 8 8 1 8 8 8 8 8 8 8 8 8 8 8 0 0 8 8 8 8 4 4 0 8 8 4 4 4 4 4 4 4 5 5 9 9 3 4 4 0 0 0 
0 0 0 0 0 0 8 8 8 8 1 8 8 8 8 8 8 8 8 8 8 8 8 0 0 8 8 8 4 4 0 8 8 4 4 4 4 4 4 4 5 5 5 9 1 4 4 0 0 0 
0 0 0 0 0 0 8 8 8 8 1 8 8 8 8 8 8 8 8 8 8 8 8 8 0 8 8 8 4 4 0 0 0 9 9 9 4 4 4 4 5 5 5 9 1 4 4 0 0 0 
0 0 0 0 0 0 8 8 8 8 1 1 1 1 1 1 1 1 1 1 1 1 1 3 2 3 1 1 4 4 4 4 9 4 9 4 9 4 4 5 5 5 9 9 1 4 4 0 0 0 
0 0 0 0 0 0 4 4 4 4 4 4 4 4 4 4 4 4 1 4 4 4 4 4 0 0 4 1 4 4 4 4 9 4 3 4 9 4 4 4 5 5 9 9 1 4 0 0 0 0 
0 0 0 0 0 4 5 5 4 4 4 4 4 5 5 10 5 5 1 4 5 5 4 4 4 0 4 1 4 4 4 4 9 4 1 4 9 4 4 4 5 5 9 9 1 0 0 0 0 0 
0 0 0 0 0 4 5 5 4 4 4 4 4 4 4 4 4 4 1 4 4 4 4 4 4 0 4 1 4 4 4 4 4 9 1 9 4 4 4 5 5 5 9 1 1 0 0 0 0 0 
0 0 0 0 4 4 5 5 4 4 4 4 6 4 4 4 6 6 1 6 4 4 4 4 4 0 4 1 4 4 4 4 4 4 1 4 4 4 4 4 4 4 9 1 4 0 0 0 0 0 
0 0 0 4 4 5 5 5 5 4 4 4 4 6 6 6 6 6 1 6 6 6 6 4 4 0 4 1 1 1 1 1 1 1 1 1 1 1 1 1 1 1 1 1 4 4 0 0 0 0 
0 0 0 4 4 4 5 5 5 4 4 4 4 6 6 6 6 6 1 6 6 6 6 6 4 0 4 4 4 4 4 4 4 4 1 4 4 4 4 4 4 9 9 1 4 4 0 0 0 0 
0 0 0 0 0 4 5 5 5 4 4 4 6 6 6 6 6 6 1 6 6 6 6 4 4 0 10 4 4 4 4 4 4 4 1 4 4 4 5 5 5 9 9 1 4 4 0 0 0 0 
0 0 0 0 0 0 4 4 5 4 4 4 4 6 6 6 6 6 1 6 6 6 4 0 0 0 0 0 0 0 4 4 4 4 1 4 4 5 5 5 5 9 9 1 4 0 0 0 0 0 
0 0 0 0 0 0 0 0 0 0 0 0 0 0 0 6 6 6 1 4 6 6 0 0 0 0 0 0 0 0 0 4 4 4 1 4 4 5 5 5 5 9 9 1 4 4 0 0 0 0 
0 0 0 0 4 10 4 4 4 4 4 4 4 4 2 4 4 4 1 4 4 4 0 0 0 4 11 4 0 0 0 4 4 4 1 4 4 5 5 5 5 9 9 1 4 4 4 0 0 0 
0 0 0 0 4 4 4 4 4 4 4 4 4 4 0 0 0 0 2 0 0 0 0 0 0 4 3 4 0 0 0 4 4 4 1 4 4 5 5 5 9 9 4 1 4 4 0 0 0 0 
0 0 0 0 0 0 0 0 0 0 0 0 0 0 0 0 0 4 1 4 0 0 0 0 0 0 2 0 0 0 0 4 4 4 1 4 5 5 5 5 9 10 4 1 4 4 0 0 0 0 
0 0 0 0 0 0 0 0 0 0 0 0 0 4 4 0 0 4 1 4 0 0 0 0 0 0 2 0 0 0 0 0 4 4 1 4 5 5 5 5 9 9 4 1 4 0 0 0 0 0 
0 0 0 4 3 1 1 1 1 1 1 1 1 1 1 2 1 1 1 4 4 0 0 0 0 0 2 0 0 0 0 4 4 4 1 4 5 5 5 5 9 4 4 1 4 4 0 0 0 0 
0 0 0 4 4 4 4 4 4 4 4 4 4 4 0 0 4 4 1 1 1 1 1 1 1 1 1 1 2 1 1 1 1 1 1 4 5 5 5 5 9 4 4 1 4 4 4 0 0 0 
0 0 0 0 0 0 0 0 0 0 0 0 0 0 0 4 4 4 1 4 4 4 4 4 4 4 1 4 0 4 4 4 4 4 4 4 5 5 5 5 9 4 4 1 4 0 0 0 0 0 
0 0 0 0 0 0 0 0 0 0 0 0 0 4 1 1 1 1 1 4 4 4 4 4 4 4 1 4 0 0 4 4 4 4 4 4 4 4 5 9 4 4 4 1 4 4 0 0 0 0 
0 0 0 0 4 5 5 5 4 4 4 4 4 4 1 4 7 7 7 7 4 4 4 7 7 7 1 4 4 0 4 4 4 4 4 4 4 10 5 9 4 4 4 1 4 4 4 0 0 0 
0 0 0 0 5 5 5 5 5 9 7 7 7 7 1 7 7 7 7 7 4 7 7 7 7 7 1 4 4 0 0 4 4 4 4 4 5 5 5 9 9 4 4 1 4 4 4 0 0 0 
0 0 0 0 0 0 0 0 0 9 7 7 7 7 1 7 7 7 7 7 7 7 7 7 7 7 1 4 4 4 0 4 4 4 4 5 5 5 5 9 3 1 1 1 4 4 0 0 0 0 
0 0 0 0 0 0 0 0 0 9 7 7 7 7 1 7 7 7 7 7 7 7 7 7 7 4 1 4 4 4 0 4 4 4 5 5 5 5 5 9 4 4 4 4 4 0 0 0 0 0 
0 0 0 0 0 0 0 0 0 9 7 7 7 7 1 7 7 7 7 7 7 7 7 7 4 4 1 3 4 4 0 4 4 4 4 5 5 5 9 4 4 6 6 6 4 0 0 0 0 0 
0 0 0 0 0 0 0 0 0 9 7 7 7 7 1 7 7 7 10 7 7 7 7 7 4 4 4 0 0 0 0 0 0 4 4 4 5 5 9 4 6 6 6 6 6 4 0 0 0 0 
0 0 0 0 0 0 0 0 0 9 10 7 7 7 1 7 7 7 7 7 7 7 7 4 4 0 0 0 0 0 0 0 0 0 4 4 5 5 5 4 6 6 6 6 6 4 4 0 0 0 
0 0 0 0 0 0 0 0 0 9 9 7 7 7 1 7 7 7 7 7 7 7 4 4 0 0 0 0 0 0 0 0 0 0 0 4 5 5 5 4 6 6 6 6 6 4 4 0 0 0 
0 0 0 0 0 0 0 0 0 4 4 7 7 7 1 7 7 7 7 7 7 7 4 0 0 0 0 0 0 0 0 0 0 0 0 0 4 4 5 4 6 6 6 6 6 4 0 0 0 0 
0 0 0 0 0 0 0 0 0 4 9 7 7 7 1 7 7 7 4 4 4 4 4 0 0 0 0 0 0 0 0 0 0 0 0 0 0 4 4 4 6 6 10 6 6 4 0 0 0 0 
0 0 0 0 0 0 0 0 0 4 4 7 7 7 1 7 4 4 4 4 4 4 4 0 0 0 0 0 0 0 0 0 0 0 0 0 0 0 4 6 6 6 6 6 4 0 0 0 0 0 
0 0 0 0 0 0 0 0 4 4 4 7 7 7 1 4 4 0 0 0 4 4 0 0 0 0 0 0 0 0 0 0 0 0 0 0 0 0 4 6 6 6 6 6 6 4 0 0 0 0 
0 0 0 0 0 0 0 0 4 4 3 1 1 1 1 0 0 0 0 0 0 0 0 0 0 0 0 0 0 0 0 0 0 0 0 0 0 0 0 4 6 6 6 6 6 4 0 0 0 0 
0 0 0 0 0 0 0 0 4 4 4 4 4 0 0 0 0 0 0 0 0 0 0 0 0 0 0 0 0 0 0 0 0 0 0 0 0 0 0 4 6 6 6 6 6 4 4 0 0 0 
0 0 0 0 0 0 0 0 0 4 4 0 0 0 0 0 0 0 0 0 0 0 0 0 0 0 0 0 0 0 0 0 0 0 0 0 0 0 0 0 4 4 6 6 4 4 4 0 0 0 
0 0 0 0 0 0 0 0 0 0 0 0 0 0 0 0 0 0 0 0 0 0 0 0 0 0 0 0 0 0 0 0 0 0 0 0 0 0 0 0 0 0 4 4 4 4 0 0 0 0 
0 0 0 0 0 0 0 0 0 0 0 0 0 0 0 0 0 0 0 0 0 0 0 0 0 0 0 0 0 0 0 0 0 0 0 0 0 0 0 0 0 0 0 0 0 0 0 0 0 0 
0 0 0 0 0 0 0 0 0 0 0 0 0 0 0 0 0 0 0 0 0 0 0 0 0 0 0 0 0 0 0 0 0 0 0 0 0 0 0 0 0 0 0 0 0 0 0 0 0 0 
0 0 0 0 0 0 0 0 0 0 0 0 0 0 0 0 0 0 0 0 0 0 0 0 0 0 0 0 0 0 0 0 0 0 0 0 0 0 0 0 0 0 0 0 0 0 0 0 0 0 
